ARXXX
XRXRX
XRXXX
XRXRX
XXXRE
,
XXXXX
XXXXX
XRARX
XXRXX
XXEXX
,
ARXEX
XXRXX
XXXRX
XXXXX
XXXXX